###################################################
#.....#.......#...#E#.....#.........#   #         #
#.###.#.#####.#.#.#.#.###.#.#######.# ### ####### #
#...#...#.....#.#...#...#.#...#   #.# #       #...#
###.#####.#####.#######.#.###.# ###.# # #######.#.#
#...#    .#.....#...#...#...#.#   #.#   #.......#.#
#.#######.#.### #.#.#.#####.#.### #.# ###.#######.#
#.#.....#.#.# # #.#...#.....#.#   #.#   #...#   #.#
#.#.###.#.#.# # #.#####.#####.# ###.### ###.# # #.#
#.#...#.#...#   #...# #.......#   #.#     #.# # #.#
#.###.#.### #######.# ##### ##### #.#######.# # #.#
#.....#...# #.....#.#       #...# #.........# # #.#
# #######.###.###.#.####### #.#.# ########### # #.#
#     # #.....  #.#...#...# #.#.#     #       # #.#
##### # #########.###.#.#.###.#.### ### # #######.#
#     #   #.......#...#.#.#...#...#     #    ...#.#
# ##### # #.#######.# #.#.#.#####.# #########.#.#.#
#     # # #.#.....#.# #.#.#.  #...# #   #S..#.#...#
##### # # #.#.###.#.###.#.#.###.### ### ###.#.#####
#   #   # #.#.#...#.#...#...#...# #     #...#...# #
# # ### ###.#.#.###.#.#######.### ##### #.#####.# #
# #   # #...#.#...#...#     #...#   #   #.#...#.# #
# # # # #.# #.###.##### #######.# ### ###.#.#.#.# #
# # # # #.# #...#.    # #.......#     #...#.#...# #
# # ### #.# ###.#.### # #.####### #####.###.##### #
# #     #.# #...#.#   # #...# #     #...# #.#     #
# #######.###.###.# ### ###.# # #####.### #.##### #
# #     #.....#...#       #.#   #...#...# #.....# #
# ### #########.##### #####.#####.#.###.# #####.# #
#     #.........#...# #...#.......#.....#   #...# #
# #####.### #####.#.###.#.################# #.### #
# #.....#   #.....#.#...#.#...  #.....#...  #.#   #
# #.##### ###.#####.#.###.#.#.###.###.#.#.###.# # #
# #.#       #.....#...  #...#...#.# #...#.#...# # #
# #.### #########.######### ###.#.# #####.#.##### #
# #...# #.........  #.....# # #.#.......#...#     #
# ###.# #.###########.###.# # #.#######.##### # ###
#   #.# #.  #...#...#.#...#   #.  #.....#     #   #
#####.# #.###.#.#.#.#.#.#######.# #.####### ##### #
#.....# #.#...#...#.#.#.......#.# #.......#     # #
#.#######.#.#######.#.#######.#.# #######.##### # #
#.........#.#     #.#.#  ...#.#.#       #.#   # # #
# #########.# # ###.#.###.#.#.#.# ##### #.# # ### #
# #     #...# # #...#...#.#...#.# #...# #.# #   # #
# # ### #.### # #.#####.#.#####.###.#.###.# ### # #
# # # # #...# # #.......#.....#...#.#...#.#   # # #
# # # # ###.### # ###########.###.#.###.#.### # # #
# # # # # #...#   #...#      .....#...#.#...# # # #
# # # # # ###.#####.#.###############.#.###.# # # #
#   #       #.......#.................#.....  #   #
###################################################
